            ##            
 #### ##### ## ##### #### 
 #### ##### ## ##### #### 
 #### ##### ## ##### #### 
                          
 #### ## ######## ## #### 
 #### ## ######## ## #### 
      ##    ##    ##      
##### ##### ## ##### #####
##### ##### ## ##### #####
##### ##          ## #####
##### ## ######## ## #####
##### ## ######## ## #####
         ########         
##### ## ######## ## #####
##### ##          ## #####
##### ## ######## ## #####
##### ## ######## ## #####
            ##            
 #### ##### ## ##### #### 
 #### ##### ## ##### #### 
   ##                ##   
## ## ## ######## ## ## ##
## ## ## ######## ## ## ##
      ##    ##    ##      
 ########## ## ########## 
 ########## ## ########## 


